0000000000000000
0000000000000000
0000111100111100
1111100110100100
0000000011111100
0000000000100000
0000000000100000
0000000000111111
0000000000000000
0000000000000000