0000000000000000
0011100000000000
0010100000111100
1110100000100100
0000111111111100
0000000000100000
0000000000100000
0000000000111111
0000000000000000
0000000000000000