0000000000000000
0000000000000000
0000000000111100
1111100000100100
0000111111111100
0000000000100000
0000000000100000
0000000000111111
0000000000000000
0000000000000000