3,44,3,0,2,1,20,21,22,0,4,5,5,5,5,5
1,4,5,5,5,6,30,31,32,43,14,12,13,11,13,12
45,14,10,11,11,16,0,0,45,0,14,11,18,25,25,25
5,7,12,23,11,16,44,0,2,3,14,11,16,45,0,2
10,10,13,11,11,16,45,43,0,0,14,12,16,2,44,1
25,17,13,35,36,38,5,5,5,6,14,13,16,0,0,3
0,14,11,11,12,10,11,12,11,8,7,13,16,44,2,3
1,24,25,25,25,25,25,17,11,13,12,11,16,0,2,2
3,0,45,1,0,44,0,24,25,25,25,25,26,0,2,2
1,1,0,43,1,1,3,0,2,0,3,1,3,1,44,3
