0,4,5,5,5,6,0,0,0,0,0,1,0,2,45,0
0,14,12,12,10,47,5,5,5,6,0,0,2,3,0,3
0,14,13,40,12,41,10,12,12,47,5,5,5,6,44,0
3,14,10,41,12,41,12,40,11,41,10,11,10,47,5,5
5,7,13,41,12,41,10,41,11,41,10,40,10,41,13,11
11,10,13,41,13,41,11,41,13,41,11,41,13,42,13,18
25,25,25,46,10,41,12,41,10,42,13,41,10,11,10,16
1,0,0,14,10,42,11,41,11,11,12,33,25,25,25,26
45,0,43,14,13,13,11,33,25,25,25,26,0,0,0,44
3,0,0,24,25,25,25,26,44,1,45,0,0,2,43,0
