5,5,5,6,0,0,0,0,0,0,1,44,3,4,5,5
12,10,13,16,44,1,3,1,45,44,0,3,3,14,12,13
25,17,12,16,2,0,0,2,1,0,43,43,0,14,11,18
2,14,11,16,0,0,0,0,0,0,45,43,45,14,11,16
0,14,12,16,44,0,1,0,44,0,0,3,1,14,13,16
0,14,13,16,1,43,0,0,1,3,44,45,44,14,11,16
0,14,12,16,0,0,0,44,0,2,1,1,0,14,10,16
3,14,10,8,5,5,5,5,5,5,5,5,5,7,11,16
2,14,10,12,11,11,11,12,10,10,12,10,11,13,13,16
0,24,25,25,25,25,25,25,25,25,25,25,25,25,25,26
