0,0,44,0,0,2,43,0,14,12,16,0,0,0,0,0
4,5,5,5,5,5,5,5,7,12,16,0,0,1,0,0
14,11,13,12,10,10,10,11,13,10,16,3,0,0,1,0
14,11,18,25,25,25,25,25,25,25,26,0,0,0,0,0
14,11,16,4,5,5,5,5,5,5,5,5,6,3,44,0
14,13,16,14,11,13,13,12,13,13,13,13,16,0,0,0
14,10,8,7,11,35,36,36,36,36,37,12,16,0,0,45
14,13,13,12,13,12,12,10,11,12,13,13,16,43,0,1
0,25,25,17,13,18,25,25,25,25,25,25,26,3,0,0
43,3,45,14,10,16,3,0,43,3,0,0,0,44,0,0
